111111111111111111111111111111
130300333030303330222200030331
103330030033033003222003303031
100300300300300302220000030331
130003000030000032200300000061
103030000000000002200000006661
136300000000000000220000000661
136000000000000003020300000061
136000000000000000223000000001
163600000040000000500000000001
166000000000000000200000000001
136000000000000032220000000001
163600000000000002222000000001
163630000000000302222200000001
136300000000000002222200000001
163000000000000322222222000001
130000000000000000022200000001
103000000000000002220000000001
133300000000000005000000000001
103000000000000222000000000001
103000000022222200000000030001
110000000222200000000003000031
111000022222220000000030333001
111122222222222220000002222222
222222222222222222200222222222
222222222222222222222222222222